. @                                 .
.....$....$......$......$............
#####################################
#                                   #
#                                   #
#####################################