. @                                 .
........$........$......$............
#####################################
#                                   #
#####################################
#                                   #
#####################################
