. @                                 .
.........$.......$.....$.............
#####################################
#                                   #
#####################################
#                                   #
#####################################
