. @                                 .
.....................................
#####################################
#                                   #
#####################################
#                                   #
#####################################
